#################
o #       #     #
# #### ##### #  #
#          # #  #
# ######## # #  #
#        # # #  #
# ###### # # #  #
#      # #   #   
#################